000000000000000000000000000000000000000000000000000000000000000000000000000000000000000000000000000000000000000000000000000000000000000000000000000000000000000000000000000000000000000
000000000000000000000000000000000000000000000000000000000000000000000000000000000000000000000000000000000000000000000000000000000000000000000000000000000000000000000000000000000000000
000000000000000000000000000000000000000000000000000000000000000000000000000000000000000000000000000000000000000000000000000000000000000000000000000000000000000000000000000000000000000
000000000000000000000000000000000000000000000000000000000000000000000000000000000000000000000000000000000000000000000000000000000000000000000000000000000000000000000000000000000000000
000000000000000000000000000000000000000000000000000000000000000000000000000000000000000000000000000000000000000000000000000000000000000000000000000000000000000000000000000000000000000
000000000000000000000000000000000000000000000000000000000000000000000000000000000000000000000000000000000000000000000000000000000000000000000000000000000000000000000000000000000000000
0000000000000000000000000000000000000000000000000000000000000000000000000000000000000000000000000000000000000007890000000000000000788890000000000000000000o0000000000000000000000000000
000000000000000000000000000000078900000000000000000000000000000000000000000000000000000000000000000000000000000000000000000000000000000000000000000000000000000000000000000000000000000
0000000000000000007890000000000000000000000000000078888900000000000000000000000000000000000000000000000422230000000000000000000422222223000000000000000o0000000000000000000000000000000
000000000000000000000000000000000000000000000000000000000000000000000000000o000000000000000000000000000r11152300000000000000000r1111111q00000000000000000000000000000000000000000000000
00000BbtpgG&v000000000000004300000000004222222300000000000000000000000000000000000000000000000000000000r11111522222300o00o00000r1111111q00000004222222222222300000042222222222222222222
2222222222222222222222222226q0000000000r11111152222222222223000000000000o000000000000000042222223000000r11111111111q00000000000r1111111q0000000r111111111111q000000r1111111111111111111
1111111111111111111111111111q0000000000r1111111111111111111q00000000000000000000000000000r111111q000000r11111111111q00000000000r1111111q0000000r111111111111q000000r1111111111111111111
1111111111111111111111111111q0000000000r1111111111111111111q00000004222222222300000000000r111111q000000r11111111111q00000000000r1111111q0000000r111111111111q000000r1111111111111111111
1111111111111111111111111111q0000000000r1111111111111111111q0000000r111111111q00000000000r111111q000000r11111111111q00000000000r1111111q0000000r111111111111q000000r1111111111111111111
1111111111111111111111111111q0000000000r1111111111111111111q0000000r111111111q00000000000r111111q000000r11111111111q00000000000r1111111q0000000r111111111111q000000r1111111111111111111
1111111111111111111111111111q0000000000r1111111111111111111q0000000r111111111q00000000000r111111q000000r11111111111q00000000000r1111111q0000000r111111111111q000000r1111111111111111111
1111111111111111111111111111q0000000000r1111111111111111111q0000000r111111111q00000000000r111111q000000r11111111111q00000000000r1111111q0000000r111111111111q000000r1111111111111111111
1111111111111111111111111111qyyyyyyyyyyr1111111111111111111qyyyyyyyr111111111qyyyyyyyyyyyr111111qyyyyyyr11111111111qyyyyyyyyyyyr1111111qyyyyyyyr111111111111qyyyyyyr1111111111111111111
111111111111111111111111111152222222222611111111111111111115222222261111111115222222222226111111522222261111111111152222222222261111111522222226111111111111522222261111111111111111111
111111111111111111111111111111111111111111111111111111111111111111111111111111111111111111111111111111111111111111111111111111111111111111111111111111111111111111111111111111111111111
111111111111111111111111111111111111111111111111111111111111111111111111111111111111111111111111111111111111111111111111111111111111111111111111111111111111111111111111111111111111111
111111111111111111111111111111111111111111111111111111111111111111111111111111111111111111111111111111111111111111111111111111111111111111111111111111111111111111111111111111111111111
111111111111111111111111111111111111111111111111111111111111111111111111111111111111111111111111111111111111111111111111111111111111111111111111111111111111111111111111111111111111111
1111111111111111111111111111111111111111111111111111111111111111111111111111111111111111111111111111111111111111111111111111111111111111111111111111111111111111111111111111111111111111